isResolved:
1

minNumberOfMoves:
9

moves:

0 0 0 1 0
1 0 1 0 0
0 1 1 0 1
0 0 0 0 1
0 1 1 0 0


0 0 0 1 0
1 0 1 0 0
1 0 1 1 0
0 0 0 0 1
0 1 1 0 0


0 0 1 1 0
1 0 0 0 0
0 1 1 0 1
0 0 1 0 1
0 1 0 0 0


0 0 1 1 0
1 0 0 0 0
1 0 1 1 0
0 0 1 0 1
0 1 0 0 0


0 1 0 0 0
0 0 1 0 1
0 1 1 0 1
1 0 0 0 0
0 0 1 1 0


0 1 0 0 0
0 0 1 0 1
1 0 1 1 0
1 0 0 0 0
0 0 1 1 0


0 1 1 0 0
0 0 0 0 1
0 1 1 0 1
1 0 1 0 0
0 0 0 1 0


0 1 1 0 0
0 0 0 0 1
1 0 1 1 0
1 0 1 0 0
0 0 0 1 0

level:

0. 1* 1* 1* 0.
1* 0. 1* 0. 1*
1* 1* 0. 1* 1*
1* 0. 1* 0. 1*
0. 1* 1* 1* 0.

end
